N asset/img/wallno.xpm
S asset/img/wallso.xpm
EA asset/img/wallea.xpm
WE asset/img/wallwe.xpm

F 255,0,0
C 0,0,0


111111111111111111
100000000000000001
100000001100000001
111100S01100001111
111111000000111111
111111111111111111
111111111111111111
111111011110111111
111111011110111111
111111111111111111
