N asset/img/wallno.xpm

EA asset/img/wallea.xpm
WE asset/img/wallwe.xpm

F 255,0,0
C 0,255,0

S asset/img/wallso.xpm

111111111111111111              1111
100000000000000001               101
100000001100000001               111
111100001100001111
1000000000011111 1
111110000000111111
111110111111111111
  11001       101
111101111111111111
111011011110111111
111111011110111111
111111111111111111
