            1111111111111
            1000000000001           1111111
            1111111111111           1000001
1111111111111000000000001           1001001
   1111111000000000111111           1000001
1111111111111111111111111           1111111




     111111111111111111
     111000000000000001
     111000001110000001
     111111001110000001
     111111100000111111
     111111111011111111
     111111111111111111
