NO asset/img/wallno.xpm


WE asset/img/wallwe.xpm

F 055,055,0


SO asset/img/wallso.xpm

EA asset/img/wallea.xpm

C 0,055,055

      1111
    11100111    111       111
    1E000001   11011     1101
    10111101   10001    110011
    11100001   11011    100001
    11100111    101     101111
     1000111111110111111101
     1100000000000000000001
      111111111000111111111
             1100011
             1000001 
             1000001
             1110111
               101      111111111111111111111111111111111
             1110111111 100000000000000000000000000000001
             1110000001 100101000111100011110111101111001
               11111001 100101000000100010010011001000001
               11111001 100111110111100011100011001000001
               11111011 100001000100000010010011001000001
                   101  100001000111100011110011001111001
                   10111100000000000000000000000000000001
                   10000111111111111111111111111111111101
               111110110000000000000000000000000000000001
               111111111111111111111111111111111111111111
