NO asset/img/wallno.xpm

EA asset/img/wallea.xpm
WE asset/img/wallwe.xpm

F 055,0,0
C 0,055,0

SO asset/img/wallso.xpm

111111111111111111             
100000000000000001              
100000N01100000001              
1111000011000010
100000000001111010
111110000000111011
111110011111111011
111100011111111001
111101011111111011
111011011110111011
111111011110111001
111111111111111111







11111111111111111
10000000000000001
10000000000000001
11111111111111111
